"filename", "language", "Java", "Java Properties", "XML", "comment", "blank", "total"
"c:\Users\PC REPORTES\Desktop\Spring\api\pom.xml", "XML", 0, 0, 9, -4, 2, 7
"c:\Users\PC REPORTES\Desktop\Spring\api\src\main\java\com\globalvia\genovias\api\ApiApplication.java", "Java", 0, 0, 0, 0, -1, -1
"c:\Users\PC REPORTES\Desktop\Spring\api\src\main\java\com\globalvia\genovias\api\auth\config\filters\JwtTokenValidator.java", "Java", 42, 0, 0, 0, 14, 56
"c:\Users\PC REPORTES\Desktop\Spring\api\src\main\java\com\globalvia\genovias\api\auth\config\security\SecurityConfig.java", "Java", 55, 0, 0, 0, 11, 66
"c:\Users\PC REPORTES\Desktop\Spring\api\src\main\java\com\globalvia\genovias\api\auth\controller\AuthController.java", "Java", 27, 0, 0, 0, 12, 39
"c:\Users\PC REPORTES\Desktop\Spring\api\src\main\java\com\globalvia\genovias\api\auth\dto\AuthCreateRoleRequest.java", "Java", 8, 0, 0, 0, 3, 11
"c:\Users\PC REPORTES\Desktop\Spring\api\src\main\java\com\globalvia\genovias\api\auth\dto\AuthCreateUserRequest.java", "Java", 9, 0, 0, 0, 2, 11
"c:\Users\PC REPORTES\Desktop\Spring\api\src\main\java\com\globalvia\genovias\api\auth\dto\AuthLoginRequest.java", "Java", 5, 0, 0, 0, 2, 7
"c:\Users\PC REPORTES\Desktop\Spring\api\src\main\java\com\globalvia\genovias\api\auth\dto\AuthResponse.java", "Java", 9, 0, 0, 0, 2, 11
"c:\Users\PC REPORTES\Desktop\Spring\api\src\main\java\com\globalvia\genovias\api\auth\model\RoleEntity.java", "Java", 26, 0, 0, 0, 5, 31
"c:\Users\PC REPORTES\Desktop\Spring\api\src\main\java\com\globalvia\genovias\api\auth\model\UserEntity.java", "Java", 32, 0, 0, 0, 11, 43
"c:\Users\PC REPORTES\Desktop\Spring\api\src\main\java\com\globalvia\genovias\api\auth\repository\RoleRepository.java", "Java", 7, 0, 0, 0, 5, 12
"c:\Users\PC REPORTES\Desktop\Spring\api\src\main\java\com\globalvia\genovias\api\auth\repository\UserRepository.java", "Java", 9, 0, 0, 0, 7, 16
"c:\Users\PC REPORTES\Desktop\Spring\api\src\main\java\com\globalvia\genovias\api\auth\service\UserDetailServiceImpl.java", "Java", 89, 0, 0, 1, 35, 125
"c:\Users\PC REPORTES\Desktop\Spring\api\src\main\java\com\globalvia\genovias\api\auth\util\JwtUtils.java", "Java", 61, 0, 0, 0, 15, 76
"c:\Users\PC REPORTES\Desktop\Spring\api\src\main\java\com\globalvia\genovias\api\config\BaseServiceConfig.java", "Java", 68, 0, 0, 2, 9, 79
"c:\Users\PC REPORTES\Desktop\Spring\api\src\main\java\com\globalvia\genovias\api\config\EntityFactoryConfig.java", "Java", 54, 0, 0, 0, 8, 62
"c:\Users\PC REPORTES\Desktop\Spring\api\src\main\java\com\globalvia\genovias\api\config\ReporteValidatorConfig.java", "Java", 37, 0, 0, 0, 8, 45
"c:\Users\PC REPORTES\Desktop\Spring\api\src\main\java\com\globalvia\genovias\api\config\ValidatorConfig.java", "Java", 11, 0, 0, 0, 6, 17
"c:\Users\PC REPORTES\Desktop\Spring\api\src\main\java\com\globalvia\genovias\api\controller\BaseController.java", "Java", 12, 0, 0, 0, 2, 14
"c:\Users\PC REPORTES\Desktop\Spring\api\src\main\java\com\globalvia\genovias\api\controller\ReporteAuxilioVialController.java", "Java", 13, 0, 0, 0, 6, 19
"c:\Users\PC REPORTES\Desktop\Spring\api\src\main\java\com\globalvia\genovias\api\controller\ReporteDiarioController.java", "Java", 14, 0, 0, 0, 6, 20
"c:\Users\PC REPORTES\Desktop\Spring\api\src\main\java\com\globalvia\genovias\api\controller\ReporteServicioGruaController.java", "Java", 13, 0, 0, 0, 6, 19
"c:\Users\PC REPORTES\Desktop\Spring\api\src\main\java\com\globalvia\genovias\api\handler\GlobalExceptionHandler.java", "Java", 42, 0, 0, 1, 11, 54
"c:\Users\PC REPORTES\Desktop\Spring\api\src\main\java\com\globalvia\genovias\api\models\base\Copyable.java", "Java", 1, 0, 0, 20, 2, 23
"c:\Users\PC REPORTES\Desktop\Spring\api\src\main\java\com\globalvia\genovias\api\models\base\Dateable.java", "Java", 5, 0, 0, 0, 3, 8
"c:\Users\PC REPORTES\Desktop\Spring\api\src\main\java\com\globalvia\genovias\api\models\base\Identificable.java", "Java", 0, 0, 0, 16, -1, 15
"c:\Users\PC REPORTES\Desktop\Spring\api\src\main\java\com\globalvia\genovias\api\models\dto\CamionetaDTO.java", "Java", 18, 0, 0, 0, 8, 26
"c:\Users\PC REPORTES\Desktop\Spring\api\src\main\java\com\globalvia\genovias\api\models\dto\DireccionDTO.java", "Java", 16, 0, 0, 0, 8, 24
"c:\Users\PC REPORTES\Desktop\Spring\api\src\main\java\com\globalvia\genovias\api\models\dto\ReporteAccidenteDTO.java", "Java", 5, 0, 0, 0, 2, 7
"c:\Users\PC REPORTES\Desktop\Spring\api\src\main\java\com\globalvia\genovias\api\models\dto\ReporteAuxilioVialDTO.java", "Java", 29, 0, 0, 0, 12, 41
"c:\Users\PC REPORTES\Desktop\Spring\api\src\main\java\com\globalvia\genovias\api\models\dto\ReporteDiarioDTO.java", "Java", 36, 0, 0, 0, 15, 51
"c:\Users\PC REPORTES\Desktop\Spring\api\src\main\java\com\globalvia\genovias\api\models\dto\ReporteServicioAmbulanciaDTO.java", "Java", 22, 0, 0, 0, 10, 32
"c:\Users\PC REPORTES\Desktop\Spring\api\src\main\java\com\globalvia\genovias\api\models\dto\ReporteServicioGruaDTO.java", "Java", 24, 0, 0, 0, 10, 34
"c:\Users\PC REPORTES\Desktop\Spring\api\src\main\java\com\globalvia\genovias\api\models\dto\ResponsableDTO.java", "Java", 15, 0, 0, 0, 7, 22
"c:\Users\PC REPORTES\Desktop\Spring\api\src\main\java\com\globalvia\genovias\api\models\dto\TipoAccidenteDTO.java", "Java", 14, 0, 0, 0, 6, 20
"c:\Users\PC REPORTES\Desktop\Spring\api\src\main\java\com\globalvia\genovias\api\models\dto\UsuarioConductorDTO.java", "Java", 1, 0, 0, 0, 1, 2
"c:\Users\PC REPORTES\Desktop\Spring\api\src\main\java\com\globalvia\genovias\api\models\entities\Camioneta.java", "Java", 39, 0, 0, 0, 10, 49
"c:\Users\PC REPORTES\Desktop\Spring\api\src\main\java\com\globalvia\genovias\api\models\entities\Categoria.java", "Java", 4, 0, 0, 0, 2, 6
"c:\Users\PC REPORTES\Desktop\Spring\api\src\main\java\com\globalvia\genovias\api\models\entities\Direccion.java", "Java", 14, 0, 0, 0, 2, 16
"c:\Users\PC REPORTES\Desktop\Spring\api\src\main\java\com\globalvia\genovias\api\models\entities\PuntoReferencia.java", "Java", 12, 0, 0, 0, 2, 14
"c:\Users\PC REPORTES\Desktop\Spring\api\src\main\java\com\globalvia\genovias\api\models\entities\ReporteAccidente.java", "Java", 12, 0, 0, 0, 3, 15
"c:\Users\PC REPORTES\Desktop\Spring\api\src\main\java\com\globalvia\genovias\api\models\entities\ReporteAuxilioVial.java", "Java", 53, 0, 0, 0, 13, 66
"c:\Users\PC REPORTES\Desktop\Spring\api\src\main\java\com\globalvia\genovias\api\models\entities\ReporteDiario.java", "Java", 62, 0, 0, 0, 16, 78
"c:\Users\PC REPORTES\Desktop\Spring\api\src\main\java\com\globalvia\genovias\api\models\entities\ReporteServicioAmbulancia.java", "Java", 45, 0, 0, 0, 10, 55
"c:\Users\PC REPORTES\Desktop\Spring\api\src\main\java\com\globalvia\genovias\api\models\entities\ReporteServicioGrua.java", "Java", 45, 0, 0, 0, 11, 56
"c:\Users\PC REPORTES\Desktop\Spring\api\src\main\java\com\globalvia\genovias\api\models\entities\Responsable.java", "Java", 40, 0, 0, 0, 10, 50
"c:\Users\PC REPORTES\Desktop\Spring\api\src\main\java\com\globalvia\genovias\api\models\entities\TipoAccidente.java", "Java", 37, 0, 0, 0, 9, 46
"c:\Users\PC REPORTES\Desktop\Spring\api\src\main\java\com\globalvia\genovias\api\models\entities\UsuarioConductor.java", "Java", 4, 0, 0, 0, 1, 5
"c:\Users\PC REPORTES\Desktop\Spring\api\src\main\java\com\globalvia\genovias\api\models\entities\Vehiculo.java", "Java", 9, 0, 0, 0, 2, 11
"c:\Users\PC REPORTES\Desktop\Spring\api\src\main\java\com\globalvia\genovias\api\repositories\CamionetaRepository.java", "Java", 5, 0, 0, 0, 5, 10
"c:\Users\PC REPORTES\Desktop\Spring\api\src\main\java\com\globalvia\genovias\api\repositories\DireccionRepository.java", "Java", 5, 0, 0, 0, 5, 10
"c:\Users\PC REPORTES\Desktop\Spring\api\src\main\java\com\globalvia\genovias\api\repositories\ReporteAccidenteRepository.java", "Java", -3, 0, 0, 0, -1, -4
"c:\Users\PC REPORTES\Desktop\Spring\api\src\main\java\com\globalvia\genovias\api\repositories\ReporteAuxilioVialRepository.java", "Java", 4, 0, 0, 0, 4, 8
"c:\Users\PC REPORTES\Desktop\Spring\api\src\main\java\com\globalvia\genovias\api\repositories\ReporteDiarioRepository.java", "Java", 4, 0, 0, 0, 4, 8
"c:\Users\PC REPORTES\Desktop\Spring\api\src\main\java\com\globalvia\genovias\api\repositories\ReporteRepository.java", "Java", 8, 0, 0, 0, 4, 12
"c:\Users\PC REPORTES\Desktop\Spring\api\src\main\java\com\globalvia\genovias\api\repositories\ReporteServicioAmbulanciaRepository.java", "Java", 4, 0, 0, 0, 4, 8
"c:\Users\PC REPORTES\Desktop\Spring\api\src\main\java\com\globalvia\genovias\api\repositories\ReporteServicioGruaRepository.java", "Java", 4, 0, 0, 0, 4, 8
"c:\Users\PC REPORTES\Desktop\Spring\api\src\main\java\com\globalvia\genovias\api\repositories\ResponsableRepository.java", "Java", 5, 0, 0, 0, 5, 10
"c:\Users\PC REPORTES\Desktop\Spring\api\src\main\java\com\globalvia\genovias\api\repositories\TipoAccidenteRepository.java", "Java", 5, 0, 0, 0, 5, 10
"c:\Users\PC REPORTES\Desktop\Spring\api\src\main\java\com\globalvia\genovias\api\services\BaseService.java", "Java", -59, 0, 0, 0, -28, -87
"c:\Users\PC REPORTES\Desktop\Spring\api\src\main\java\com\globalvia\genovias\api\services\ReporteDiarioService.java", "Java", 15, 0, 0, 0, 6, 21
"c:\Users\PC REPORTES\Desktop\Spring\api\src\main\java\com\globalvia\genovias\api\services\UsuarioConductorService.java", "Java", -16, 0, 0, 0, -11, -27
"c:\Users\PC REPORTES\Desktop\Spring\api\src\main\java\com\globalvia\genovias\api\services\VehiculoService.java", "Java", -18, 0, 0, 0, -9, -27
"c:\Users\PC REPORTES\Desktop\Spring\api\src\main\java\com\globalvia\genovias\api\services\base\BaseCrudService.java", "Java", 102, 0, 0, 12, 29, 143
"c:\Users\PC REPORTES\Desktop\Spring\api\src\main\java\com\globalvia\genovias\api\services\base\ReporteBaseCrudService.java", "Java", 26, 0, 0, 0, 9, 35
"c:\Users\PC REPORTES\Desktop\Spring\api\src\main\java\com\globalvia\genovias\api\services\base\interfaces\BaseService.java", "Java", 22, 0, 0, 0, 11, 33
"c:\Users\PC REPORTES\Desktop\Spring\api\src\main\java\com\globalvia\genovias\api\services\dto\DTOProcessService.java", "Java", 1, 0, 0, 0, -1, 0
"c:\Users\PC REPORTES\Desktop\Spring\api\src\main\java\com\globalvia\genovias\api\services\dto\ReportServicioGruaDTOProcess.java", "Java", 21, 0, 0, 0, 8, 29
"c:\Users\PC REPORTES\Desktop\Spring\api\src\main\java\com\globalvia\genovias\api\services\dto\ReporteAccidenteDTOProcess.java", "Java", 16, 0, 0, 0, -1, 15
"c:\Users\PC REPORTES\Desktop\Spring\api\src\main\java\com\globalvia\genovias\api\services\dto\ReporteAuxilioVialDTOService.java", "Java", 28, 0, 0, 0, 13, 41
"c:\Users\PC REPORTES\Desktop\Spring\api\src\main\java\com\globalvia\genovias\api\services\dto\ReporteDiarioDTOProcess.java", "Java", 29, 0, 0, 0, 14, 43
"c:\Users\PC REPORTES\Desktop\Spring\api\src\main\java\com\globalvia\genovias\api\services\dto\ReporteServicioAmbulanciaDTOProcess.java", "Java", 21, 0, 0, 0, 9, 30
"c:\Users\PC REPORTES\Desktop\Spring\api\src\main\java\com\globalvia\genovias\api\services\dto\VehiculoDTOProcess.java", "Java", 1, 0, 0, 0, 0, 1
"c:\Users\PC REPORTES\Desktop\Spring\api\src\main\java\com\globalvia\genovias\api\validator\ReporteAccidenteValidator.java", "Java", -22, 0, 0, 0, -11, -33
"c:\Users\PC REPORTES\Desktop\Spring\api\src\main\java\com\globalvia\genovias\api\validator\UsuarioConductorValidator.java", "Java", -10, 0, 0, 0, -6, -16
"c:\Users\PC REPORTES\Desktop\Spring\api\src\main\java\com\globalvia\genovias\api\validator\Validator.java", "Java", -26, 0, 0, 0, -19, -45
"c:\Users\PC REPORTES\Desktop\Spring\api\src\main\java\com\globalvia\genovias\api\validator\VehiculoValidator.java", "Java", -10, 0, 0, 0, -6, -16
"c:\Users\PC REPORTES\Desktop\Spring\api\src\main\java\com\globalvia\genovias\api\validator\base\ReporteValidator.java", "Java", 19, 0, 0, 1, 9, 29
"c:\Users\PC REPORTES\Desktop\Spring\api\src\main\java\com\globalvia\genovias\api\validator\base\Validator.java", "Java", 16, 0, 0, 1, 8, 25
"c:\Users\PC REPORTES\Desktop\Spring\api\src\main\java\com\globalvia\genovias\api\validator\base\VoidCallback.java", "Java", 5, 0, 0, 0, 4, 9
"c:\Users\PC REPORTES\Desktop\Spring\api\src\main\resources\application.properties", "Java Properties", 0, 2, 0, 0, 1, 3
"Total", "-", 1407, 2, 9, 50, 429, 1897